40
40
20 20 20 20 20 20 20 20 20 20 20 20 20 20 20 20 20 20 20 20 20 20 20 20 20 20 20 20 20 20 20 20 20 20 20 20 20 20 20 20 
20 20 20 20 3 1 20 20 20 20 20 20 20 20 20 20 20 20 20 20 20 20 20 20 20 20 20 20 20 20 20 20 20 20 20 20 20 20 20 20 
20 20 2 1 1 2 1 1 20 20 2 1 2 20 20 20 20 20 20 20 20 1 1 1 1 20 20 20 20 20 20 1 1 1 1 1 1 20 20 20 
20 20 1 1 2 1 1 3 1 1 1 4 4 4 20 20 20 20 20 20 1 1 3 2 1 1 20 20 20 20 1 3 1 2 1 2 1 1 20 20 
20 20 1 1 3 1 1 1 1 3 4 4 4 4 20 20 20 20 20 1 2 1 1 1 1 1 1 4 4 1 1 3 1 1 1 3 1 1 20 20 
20 20 2 1 1 1 2 1 2 2 4 4 4 4 20 20 20 20 20 1 1 1 1 1 1 2 1 4 4 1 1 1 3 1 2 1 1 20 20 20 
20 20 20 3 1 20 20 20 20 2 4 4 4 20 20 20 20 20 1 1 3 3 1 20 20 1 1 4 4 4 1 1 2 1 1 1 20 20 20 20 
20 20 20 20 20 20 20 20 20 20 4 4 4 20 20 20 20 20 1 1 20 20 20 20 20 20 20 4 4 4 20 20 20 20 20 20 20 20 20 20 
20 20 20 20 20 20 20 20 20 20 4 4 4 20 20 20 20 20 1 1 20 20 20 20 20 20 20 4 4 4 20 20 20 20 20 20 20 20 20 20 
20 20 20 20 20 20 20 20 20 1 3 4 4 1 1 20 20 20 1 3 20 20 20 20 20 20 4 4 4 4 20 20 20 20 20 20 20 20 20 20 
20 20 20 1 1 1 1 20 20 1 1 4 4 4 1 20 20 1 1 1 1 20 20 20 20 4 4 4 4 4 20 20 20 20 1 1 20 20 20 20 
20 20 1 1 3 1 1 20 20 1 4 4 4 4 2 20 20 1 2 1 1 1 20 20 20 4 4 4 4 20 20 20 20 1 3 1 1 20 20 20 
20 20 1 3 1 3 1 1 1 1 4 4 4 4 1 1 1 1 1 2 1 2 20 20 20 4 4 20 20 20 20 20 20 1 2 1 1 3 20 20 
20 20 1 1 3 1 1 20 20 1 4 4 4 1 3 1 3 1 3 1 1 1 20 20 20 3 1 20 20 1 1 3 1 1 2 1 1 1 20 20 
20 20 20 1 1 1 1 20 20 3 1 4 4 2 1 20 20 2 1 1 1 20 20 20 20 1 2 1 20 1 20 20 20 1 1 1 1 20 20 20 
20 20 20 20 1 20 20 20 20 20 20 20 20 20 2 20 20 20 20 20 20 20 20 20 20 20 20 1 20 2 20 20 20 20 20 1 2 20 20 20 
20 20 20 20 1 20 20 20 20 20 20 20 20 20 1 20 20 20 20 20 20 20 20 20 20 20 20 1 20 1 20 20 20 20 20 1 1 20 20 20 
20 20 20 20 21 20 20 20 20 20 20 1 1 2 1 20 20 1 1 1 1 1 1 20 20 2 3 1 20 1 20 20 20 20 20 3 1 20 20 20 
20 20 2 3 1 20 20 20 20 20 1 3 20 20 20 20 20 1 1 3 1 2 1 20 20 21 20 20 20 2 1 20 20 20 20 1 1 20 20 20 
20 20 1 20 20 20 20 20 20 1 1 20 20 20 20 20 20 1 2 1 1 3 1 20 20 3 1 2 20 20 1 20 20 20 20 20 1 20 20 20 
20 20 3 2 1 2 1 3 1 2 1 20 20 20 1 1 21 1 1 2 1 2 1 20 20 1 20 1 3 1 1 20 20 20 20 20 2 20 20 20 
20 20 20 20 20 20 20 20 20 1 1 1 20 20 20 20 20 1 3 2 1 1 3 20 20 2 20 20 20 20 20 20 20 20 20 20 1 20 20 20 
20 20 20 20 20 20 20 20 20 20 3 1 20 20 20 20 20 3 1 1 1 1 1 20 20 1 1 3 1 3 1 20 20 20 20 20 3 20 20 20 
20 20 20 20 20 20 20 20 20 20 20 1 20 20 20 20 20 20 20 20 20 20 20 20 20 20 20 20 20 20 1 20 20 20 20 20 1 20 20 20 
20 20 20 20 20 20 20 20 20 20 20 21 20 20 20 20 20 20 20 1 1 20 20 20 20 20 20 20 20 20 1 20 20 20 20 20 1 20 20 20 
20 20 20 20 20 20 20 20 20 20 20 1 4 20 20 20 20 20 1 1 1 20 20 20 20 20 20 3 1 1 1 20 20 20 20 20 1 3 1 20 
20 20 20 1 3 20 20 20 20 1 2 1 4 4 20 20 20 20 1 2 1 3 20 20 20 20 1 1 2 1 1 20 20 20 20 20 3 1 3 20 
20 20 1 1 1 2 1 20 1 1 3 4 4 4 4 20 20 20 1 3 1 2 20 20 20 2 1 3 1 1 1 3 1 3 20 20 20 3 20 20 
20 20 1 2 1 2 3 20 1 1 4 4 4 4 1 20 20 1 2 1 3 2 20 20 20 1 1 2 1 3 1 1 2 1 2 20 20 20 20 20 
20 20 20 1 1 1 1 20 20 20 4 4 4 3 1 1 1 3 1 1 1 1 20 20 20 3 1 1 2 1 20 20 20 3 1 4 4 4 4 20 
20 20 20 3 1 2 1 20 20 20 20 4 4 20 20 20 20 1 20 20 20 1 1 1 1 1 3 1 1 20 20 20 20 1 4 4 4 4 4 20 
20 20 20 2 1 20 20 20 20 20 20 20 20 20 20 20 20 20 20 20 20 20 20 20 20 20 20 20 20 20 20 20 20 20 20 4 4 4 4 20 
20 20 20 1 1 20 20 20 20 20 20 20 20 20 20 20 20 1 20 20 20 1 20 20 20 20 20 20 20 20 20 20 20 20 20 4 4 4 4 20 
20 20 20 1 1 20 20 20 20 20 20 20 20 20 1 1 1 3 20 20 20 1 1 1 1 3 1 20 20 20 20 20 20 20 4 4 4 4 4 20 
20 20 1 3 1 20 20 20 20 20 20 3 1 1 2 20 20 20 20 20 20 1 3 1 1 1 2 1 20 20 20 20 20 20 4 4 4 4 4 20 
20 20 2 1 1 20 20 20 20 20 20 2 20 20 20 20 20 20 20 20 1 2 1 3 1 3 1 3 1 20 20 20 20 20 4 4 4 4 4 20 
20 20 1 1 2 1 20 20 20 20 20 21 20 20 20 20 20 20 20 20 1 1 1 1 2 1 2 1 1 20 20 20 20 20 20 4 4 4 20 20 
20 20 20 1 3 1 1 1 1 1 2 1 20 20 20 20 20 20 20 20 20 3 1 1 3 1 2 1 20 20 20 20 20 20 20 1 1 1 20 20 
20 20 20 20 1 2 20 20 20 20 20 20 20 20 20 20 20 20 20 20 20 20 20 20 20 1 1 20 20 20 20 20 20 20 20 20 1 20 20 20 
20 20 20 20 20 20 20 20 20 20 20 20 20 20 20 20 20 20 20 20 20 20 20 20 20 20 20 20 20 20 20 20 20 20 20 20 20 20 20 20 
