16
8
01 01 01 01 01 01 01 01 01 01 01 01 01 01 01 01
01 70 72 71 72 70 71 01 01 55 55 55 55 55 55 01
01 62 62 62 62 62 62 01 01 62 69 66 66 68 62 01
01 70 41 75 76 41 72 01 01 62 66 66 66 66 62 01
01 62 64 85 86 64 62 01 01 62 66 66 66 66 62 01
01 62 64 64 64 64 62 01 01 62 68 66 66 69 62 01
01 62 62 62 62 62 62 01 01 62 62 62 62 62 62 01
01 01 01 01 01 01 01 01 01 01 01 01 62 01 01 01
