40
40
09 09 09 09 09 09 09 09 09 09 09 09 09 09 09 09 09 09 09 09 09 09 09 09 09 09 09 09 09 09 09 09 09 09 09 09 09 09 09 09 
09 12 12 12 12 12 12 09 09 12 12 12 12 12 12 09 09 12 12 12 12 12 12 09 09 12 12 12 12 12 12 09 09 12 12 12 12 12 12 09
09 30 30 30 30 30 30 09 09 30 30 30 30 30 30 09 09 30 30 30 30 30 30 09 09 30 30 30 30 30 30 09 09 30 30 30 30 30 30 09
09 21 21 21 21 21 21 12 12 21 21 21 21 21 21 12 12 21 21 21 21 21 21 12 12 21 21 21 21 21 21 12 12 21 21 21 21 21 21 09
09 21 03 03 03 03 03 30 30 21 03 03 03 03 03 30 30 21 03 03 03 03 03 30 30 21 03 03 03 03 03 30 30 21 03 03 03 03 03 09
09 21 03 03 03 03 03 03 03 03 03 03 03 03 03 03 03 03 03 03 03 03 03 03 03 03 03 03 03 03 03 03 03 03 03 03 03 03 03 09
09 21 03 03 03 03 03 09 09 21 03 03 03 03 03 09 09 21 03 03 03 03 03 09 09 21 03 03 03 03 03 09 09 21 03 03 03 03 03 09
09 09 09 03 09 09 09 09 09 09 09 09 09 09 09 09 09 09 09 09 09 09 09 09 09 09 09 09 09 09 09 09 09 09 09 09 09 09 09 09 
09 09 09 09 09 09 09 09 09 09 09 09 09 09 09 09 09 09 09 09 09 09 09 09 09 09 09 09 09 09 09 09 09 09 09 09 09 09 09 09 
09 12 12 12 12 12 12 09 09 12 12 12 12 12 12 09 09 12 12 12 12 12 12 09 09 12 12 12 12 12 12 09 09 12 12 12 12 12 12 09
09 30 30 30 30 30 30 09 09 30 30 30 30 30 30 09 09 30 30 30 30 30 30 09 09 30 30 30 30 30 30 09 09 30 30 30 30 30 30 09
09 21 21 21 21 21 21 12 12 21 21 21 21 21 21 12 12 21 21 21 21 21 21 12 12 21 21 21 21 21 21 12 12 21 21 21 21 21 21 09
09 21 03 03 03 03 03 30 30 21 03 03 03 03 03 30 30 21 03 03 03 03 03 30 30 21 03 03 03 03 03 30 30 21 03 03 03 03 03 09
09 21 03 03 03 03 03 03 03 03 03 03 03 03 03 03 03 03 03 03 03 03 03 03 03 03 03 03 03 03 03 03 03 03 03 03 03 03 03 09
09 21 03 03 03 03 03 09 09 21 03 03 03 03 03 09 09 21 03 03 03 03 03 09 09 21 03 03 03 03 03 09 09 21 03 03 03 03 03 09
09 09 09 09 09 09 09 09 09 09 09 09 09 09 09 09 09 09 09 09 09 09 09 09 09 09 09 09 09 09 09 09 09 09 09 09 09 09 09 09 
09 09 09 09 09 09 09 09 09 09 09 09 09 09 09 09 09 09 09 09 09 09 09 09 09 09 09 09 09 09 09 09 09 09 09 09 09 09 09 09 
09 12 12 12 12 12 12 09 09 12 12 12 12 12 12 09 09 12 12 12 12 12 12 09 09 12 12 12 12 12 12 09 09 12 12 12 12 12 12 09
09 30 30 30 30 30 30 09 09 30 30 30 30 30 30 09 09 30 30 30 30 30 30 09 09 30 30 30 30 30 30 09 09 30 30 30 30 30 30 09
09 21 21 21 21 21 21 12 12 21 21 21 21 21 21 12 12 21 21 21 21 21 21 12 12 21 21 21 21 21 21 12 12 21 21 21 21 21 21 09
09 21 03 03 03 03 03 30 30 21 03 03 03 03 03 30 30 21 03 03 03 03 03 30 30 21 03 03 03 03 03 30 30 21 03 03 03 03 03 09
09 21 03 03 03 03 03 03 03 03 03 03 03 03 03 03 03 03 03 03 03 03 03 03 03 03 03 03 03 03 03 03 03 03 03 03 03 03 03 09
09 21 03 03 03 03 03 09 09 21 03 03 03 03 03 09 09 21 03 03 03 03 03 09 09 21 03 03 03 03 03 09 09 21 03 03 03 03 03 09
09 09 09 09 09 09 09 09 09 09 09 09 09 09 09 09 09 09 09 09 09 09 09 09 09 09 09 09 09 09 09 09 09 09 09 09 09 09 09 09 
09 09 09 09 09 09 09 09 09 09 09 09 09 09 09 09 09 09 09 09 09 09 09 09 09 09 09 09 09 09 09 09 09 09 09 09 09 09 09 09 
09 12 12 12 12 12 12 09 09 12 12 12 12 12 12 09 09 12 12 12 12 12 12 09 09 12 12 12 12 12 12 09 09 12 12 12 12 12 12 09
09 30 30 30 30 30 30 09 09 30 30 30 30 30 30 09 09 30 30 30 30 30 30 09 09 30 30 30 30 30 30 09 09 30 30 30 30 30 30 09
09 21 21 21 21 21 21 12 12 21 21 21 21 21 21 12 12 21 21 21 21 21 21 12 12 21 21 21 21 21 21 12 12 21 21 21 21 21 21 09
09 21 03 03 03 03 03 30 30 21 03 03 03 03 03 30 30 21 03 03 03 03 03 30 30 21 03 03 03 03 03 30 30 21 03 03 03 03 03 09
09 21 03 03 03 03 03 03 03 03 03 03 03 03 03 03 03 03 03 03 03 03 03 03 03 03 03 03 03 03 03 03 03 03 03 03 03 03 03 09
09 21 03 03 03 03 03 09 09 21 03 03 03 03 03 09 09 21 03 03 03 03 03 09 09 21 03 03 03 03 03 09 09 21 03 03 03 03 03 09
09 09 09 09 09 09 09 09 09 09 09 09 09 09 09 09 09 09 09 09 09 09 09 09 09 09 09 09 09 09 09 09 09 09 09 09 09 09 09 09 
09 09 09 09 09 09 09 09 09 09 09 09 09 09 09 09 09 09 09 09 09 09 09 09 09 09 09 09 09 09 09 09 09 09 09 09 09 09 09 09 
09 12 12 12 12 12 12 09 09 12 12 12 12 12 12 09 09 12 12 12 12 12 12 09 09 12 12 12 12 12 12 09 09 12 12 12 12 12 12 09
09 21 21 21 21 21 21 12 12 21 21 21 21 21 21 12 12 21 21 21 21 21 21 12 12 21 21 21 21 21 21 12 12 21 21 21 21 21 21 09
09 21 03 03 03 03 03 30 30 21 03 03 03 03 03 30 30 21 03 03 03 03 03 30 30 21 03 03 03 03 03 30 30 21 03 03 03 03 03 09
09 21 03 03 03 03 03 03 03 03 03 03 03 03 03 03 03 03 03 03 03 03 03 03 03 03 03 03 03 03 03 03 03 03 03 03 03 03 03 09
09 21 03 03 03 03 03 09 09 21 03 03 03 03 03 09 09 21 03 03 03 03 03 09 09 21 03 03 03 03 03 09 09 21 03 03 03 03 03 09
09 21 03 03 03 03 03 09 09 21 03 03 03 03 03 09 09 21 03 03 03 03 03 09 09 21 03 03 03 03 03 09 09 21 03 03 03 03 03 09
09 09 09 09 09 09 09 09 09 09 09 09 09 09 09 09 09 09 09 09 09 09 09 09 09 09 09 09 09 09 09 09 09 09 09 09 09 09 09 09 