40
40
20 20 20 20 20 20 20 20 20 20 20 20 20 20 20 20 20 20 20 20 20 20 20 20 20 20 20 20 20 20 20 20 20 20 20 20 20 20 20 20 
20 20 20 20 3 0 20 20 20 20 20 20 20 20 20 20 20 20 20 20 20 20 20 20 20 20 20 20 20 20 20 20 20 20 20 20 20 20 20 20 
20 20 2 0 0 2 0 0 20 20 2 0 2 20 20 20 20 20 20 20 20 0 0 0 0 20 20 20 20 20 20 0 0 0 0 0 0 20 20 20 
20 20 0 0 2 0 0 3 0 0 0 22 22 22 20 20 20 20 20 20 0 0 3 2 0 0 20 20 20 20 0 3 0 2 0 2 0 0 20 20 
20 20 0 0 3 0 0 0 0 3 22 22 22 22 20 20 20 20 20 0 2 0 0 0 0 0 0 22 22 0 0 3 0 0 0 3 0 0 20 20 
20 20 2 0 0 0 2 0 2 2 22 22 22 22 20 20 20 20 20 0 0 0 0 0 0 2 0 22 22 0 0 0 3 0 2 0 0 20 20 20 
20 20 20 3 0 20 20 20 20 2 22 22 22 20 20 20 20 20 0 0 3 3 0 20 20 0 0 22 22 22 0 0 2 0 0 0 20 20 20 20 
20 20 20 20 20 20 20 20 20 20 22 22 22 20 20 20 20 20 0 0 20 20 20 20 20 20 20 22 22 22 20 20 20 20 20 20 20 20 20 20 
20 20 20 20 20 20 20 20 20 20 22 22 22 20 20 20 20 20 0 0 20 20 20 20 20 20 20 22 22 22 20 20 20 20 20 20 20 20 20 20 
20 20 20 20 20 20 20 20 20 0 3 22 22 0 0 20 20 20 0 3 20 20 20 20 20 20 22 22 22 22 20 20 20 20 20 20 20 20 20 20 
20 20 20 0 0 0 0 20 20 0 0 22 22 22 0 20 20 0 0 0 0 20 20 20 20 22 22 22 22 22 20 20 20 20 0 0 20 20 20 20 
20 20 0 0 3 0 0 20 20 0 22 22 22 22 2 20 20 0 2 0 0 0 20 20 20 22 22 22 22 20 20 20 20 0 3 0 0 20 20 20 
20 20 0 3 0 3 0 0 0 0 22 22 22 22 0 0 0 0 0 2 0 2 20 20 20 22 22 20 20 20 20 20 20 0 2 0 0 3 20 20 
20 20 0 0 3 0 0 20 20 0 22 22 22 0 3 0 3 0 3 0 0 0 20 20 20 3 0 20 20 0 0 3 0 0 2 0 0 0 20 20 
20 20 20 0 0 0 0 20 20 3 0 22 22 2 0 20 20 2 0 0 0 20 20 20 20 0 2 0 20 0 20 20 20 0 0 0 0 20 20 20 
20 20 20 20 0 20 20 20 20 20 20 20 20 20 2 20 20 20 20 20 20 20 20 20 20 20 20 0 20 2 20 20 20 20 20 0 2 20 20 20 
20 20 20 20 0 20 20 20 20 20 20 20 20 20 0 20 20 20 20 20 20 20 20 20 20 20 20 0 20 0 20 20 20 20 20 0 0 20 20 20 
20 20 20 20 20 20 20 20 20 20 20 0 0 2 0 20 20 0 0 0 0 0 0 20 20 2 3 0 20 0 20 20 20 20 20 3 0 20 20 20 
20 20 2 3 0 20 20 20 20 20 0 3 20 20 20 20 20 0 0 3 0 2 0 20 20 20 20 20 20 2 0 20 20 20 20 0 0 20 20 20 
20 20 0 20 20 20 20 20 20 0 0 20 20 20 20 20 20 0 2 0 0 3 0 20 20 3 0 2 20 20 0 20 20 20 20 20 0 20 20 20 
20 20 3 2 0 2 0 3 0 2 0 20 20 20 0 0 20 0 0 2 0 2 0 20 20 0 20 0 3 0 0 20 20 20 20 20 2 20 20 20 
20 20 20 20 20 20 20 20 20 0 0 0 20 20 20 20 20 0 3 2 0 0 3 20 20 2 20 20 20 20 20 20 20 20 20 20 0 20 20 20 
20 20 20 20 20 20 20 20 20 20 3 0 20 20 20 20 20 3 0 0 0 0 0 20 20 0 0 3 0 3 0 20 20 20 20 20 3 20 20 20 
20 20 20 20 20 20 20 20 20 20 20 0 20 20 20 20 20 20 20 20 20 20 20 20 20 20 20 20 20 20 0 20 20 20 20 20 0 20 20 20 
20 20 20 20 20 20 20 20 20 20 20 20 20 20 20 20 20 20 20 0 0 20 20 20 20 20 20 20 20 20 0 20 20 20 20 20 0 20 20 20 
20 20 20 20 20 20 20 20 20 20 20 0 22 20 20 20 20 20 0 0 0 20 20 20 20 20 20 3 0 0 0 20 20 20 20 20 0 3 0 20 
20 20 20 0 3 20 20 20 20 0 2 0 22 22 20 20 20 20 0 2 0 3 20 20 20 20 0 0 2 0 0 20 20 20 20 20 3 0 3 20 
20 20 0 0 0 2 0 20 0 0 3 22 22 22 22 20 20 20 0 3 0 2 20 20 20 2 0 3 0 0 0 3 0 3 20 20 20 3 20 20 
20 20 0 2 0 2 3 20 0 0 22 22 22 22 0 20 20 0 2 0 3 2 20 20 20 0 0 2 0 3 0 0 2 0 2 20 20 20 20 20 
20 20 20 0 0 0 0 20 20 20 22 22 22 3 0 0 0 3 0 0 0 0 20 20 20 3 0 0 2 0 20 20 20 3 0 22 22 22 22 20 
20 20 20 3 0 2 0 20 20 20 20 22 22 20 20 20 20 0 20 20 20 0 0 0 0 0 3 0 0 20 20 20 20 0 22 22 22 22 22 20 
20 20 20 2 0 20 20 20 20 20 20 20 20 20 20 20 20 20 20 20 20 20 20 20 20 20 20 20 20 20 20 20 20 20 20 22 22 22 22 20 
20 20 20 0 0 20 20 20 20 20 20 20 20 20 20 20 20 0 20 20 20 0 20 20 20 20 20 20 20 20 20 20 20 20 20 22 22 22 22 20 
20 20 20 0 0 20 20 20 20 20 20 20 20 20 0 0 0 3 20 20 20 0 0 0 0 3 0 20 20 20 20 20 20 20 22 22 22 22 22 20 
20 20 0 3 0 20 20 20 20 20 20 3 0 0 2 20 20 20 20 20 20 0 3 0 0 0 2 0 20 20 20 20 20 20 22 22 22 22 22 20 
20 20 2 0 0 20 20 20 20 20 20 2 20 20 20 20 20 20 20 20 0 2 0 3 0 3 0 3 0 20 20 20 20 20 22 22 22 22 22 20 
20 20 0 0 2 0 20 20 20 20 20 20 20 20 20 20 20 20 20 20 0 0 0 0 2 0 2 0 0 20 20 20 20 20 20 22 22 22 20 20 
20 20 20 0 3 0 0 0 0 0 2 0 20 20 20 20 20 20 20 20 20 3 0 0 3 0 2 0 20 20 20 20 20 20 20 0 0 0 20 20 
20 20 20 20 0 2 20 20 20 20 20 20 20 20 20 20 20 20 20 20 20 20 20 20 20 0 0 20 20 20 20 20 20 20 20 20 0 20 20 20 
20 20 20 20 20 20 20 20 20 20 20 20 20 20 20 20 20 20 20 20 20 20 20 20 20 20 20 20 20 20 20 20 20 20 20 20 20 20 20 20 
