16
8
00 00 00 00 00 00 00 00 00 00 00 00 00 00 00 00
00 00 00 00 00 00 00 00 00 00 00 00 00 00 00 00
00 06 06 06 06 06 06 00 00 06 06 06 06 06 06 00
00 00 00 00 00 00 00 00 00 00 00 00 00 00 00 00
00 06 06 04 04 06 06 06 06 00 00 00 00 00 00 00
00 00 00 06 06 00 00 00 00 00 00 00 00 00 00 00
00 00 00 00 00 00 00 00 00 00 00 00 00 00 00 00
00 00 00 00 00 00 00 00 00 00 00 00 00 00 00 00
